NO ./rscs/N256g.png
SO ./rscs/S256g.png
EA ./rscs/E256g.png
WE ./rscs/W256g.png

F 33,123,0
C 32,11,123
    
        1111111111111111111111111  111111111111
        10000000001100000000000S1  100000000001
        1011000011110000000000001  100111111101
        1001000000000000000000001111001     101
111111111011000001110000000000000000001     101
100000000011000001110111111111111111111     101
11110111111111011100000010001              1101
11111111111111011101010010001       111111110011
             1011100000010001       100000100001
11111111111111001100000010001       111110000001
10000000000100001101010000001           11111101 
10000001111111111111111111111   11111        101
10000001                        1000111111111101
10011111   1111                 1010000000000001
101        100111111111         1011111111111111
101  1111110000000000011        101
101111000000011111111111        111
10000001111111
11111111
   
	
