C   123,55,44
F   44,66,00
NO  ./rscs/N256g.png
SO  ./rscs/S256g.png
EA  ./rscs/E256g.png
WE  ./rscs/W256g.png

 11111111111111
 10011011001101
 1000000000001
 1000001000001
 1000000000001
100111W00000001
1001 101111111
1111 111
