C       213,55,44 
        F    44    ,   66  , 00              
  NO     ./rscs/N256g.png                
        SO       ./rscs/S256g.png    
    
        EA         ./rscs/E256g.png  
        
         WE     ./rscs/W256g.png            


111111111111111111111111   111
100000000000000000000001   101
111111111111111111111101   101
                     101   101
111111111111111111   101   101
100000000000000001   101   101
101111111111111101   101   101
101            101   101   101
101   111111111101   101   101
101   100000000001   101   101
101   10111110N001111101   101
101   101   100000000001   101
101   101   101111111111   101
101   101   101            101
101   101   101111111111111101
101   101   100000000000000001
101   101   111111111111111111
101   101                 
101   101111111111111111111111
101   100000000000000000000001
111   111111111111111111111101
                           101
111   111111111111111111111101
101   100000000000000000000001
101   101111111111111111111111
101   101                     
101   101   111111111111111111
101   101   100000000000000001
101   101   101111111111111101
101   101   101            101
101   101   101111111111   101
101   101   100000000001   101
101   101111100001111101   101
101   100000000001   101   101
101   111111111101   101   101
101            101   101   101
101111111111111101   101   101
100000000000000001   101   101
111111111111111111   101   101
                     101   101
111111111111111111111101   101
100000000000000000000001   101
111111111111111111111111   111