C   123,55,44
F   44,66,00
NO  ./rscs/N256g.png
SO  ./rscs/S256g.png
EA  ./rscs/E256g.png
WE  ./rscs/W256g.png

 1111111111111111111111111
 1000000000110000000000011
 1001000000000000000000011
11110110000011100000000001
10000110000011101111111111
 111111111011100000010001
111111111011101010010001
100110101011100000010001
100000000001100000010001
100000000001100000010001
100000000001100000010001
100000000001100000010001
100000000001100000010001
100000000001100000010001
100000000001100000010001
100000000001100000010001
100000000001100000010001
100000000001100000010001
100000000001100000010001
100000000001100000010001
100000000001100000010001
100000000001100000010001
100000000001100000010001
100000000001100000010001
100000000001100000010001
100000000001100000010001
100000000001100000010001
1000000000011010100000011
101110101011111011110W001
101 1110101 1011110000011
111 1111111 111111111111

