C        123,55,44

  NO     ./rscs/N256g.png
        SO       ./rscs/S256g.png

        EA         ./rscs/E256g.png

        F    44    ,   66  , 00
         WE     ./rscs/W256g.png


        1111111111111111111111111
        1000000000110000000000001
        1011000001110000000000001
        1001000000000000000000001
111111111011000001110000000000001
100000000011000001110111111111111
11110111111111011100000010001
11110111111111011101010010001
11000000110101011100000010001
10000000000000001100000010001
100000000000000011010100000011111111
10000001110101011111011110W000000001
10000001 1110101 1011110000011111111
11111111 1111111 111111111111

