C   123,55,44
F   44,66,00
NO  ./rscs/N256g.png
SO  ./rscs/S256g.png
EA  ./rscs/E256g.png
WE  ./rscs/W256g.png

 1111111
 1001101
 1000001
100111W1
1001 101
1111 111
